основн`ой ч`асти	 По заверш`ении основн`ой ч`асти церем`онии откр`ытия Игр на стади`оне в прис`утствии премьер-мин`истра Гр`еции Константиноса Караманлиса и презид`ента Междунар`одного Олимп`ийского комит`ета Жака Рогге был п`однят Паралимпийский флаг и зажжён 
Олимп`ийского комит`ета	 По заверш`ении основн`ой ч`асти церем`онии откр`ытия Игр на стади`оне в прис`утствии премьер-мин`истра Гр`еции Константиноса Караманлиса и презид`ента Междунар`одного Олимп`ийского комит`ета Жака Рогге был п`однят Паралимпийский флаг и зажжён 
паралимпийского комит`ета	 Уч`астников и гост`ей Игр прив`етствовали презид`ент Оргкомит`ета Аф`ины 2004 Ио`анна Ангелопулос-Даскалаки и презид`ент Междунар`одного паралимпийского комит`ета МПК 
0во`енного сов`ета	 78-летний кит`айский л`идер Цзян Цзэминь п`одал прош`ение об отст`авке с пост`а председ`ателя Центр`ального во`енного сов`ета ЦВС КНР на проход`ящем в Пекине пл`енуме ЦК 
кит`айской стол`ицы	 Об `этом сообщ`ает сег`одня из кит`айской стол`ицы изда`ющаяся в Сянгане информированная газ`ета Саут Чайна морнинг пост ссыл`аясь на 
генер`ального секретар`я	 Тогд`а же произойдёт утвержд`ение на пост`у председ`ателя ЦВС председ`ателя КНР и генер`ального секретар`я ЦК КПК 61-летнего 
61-летнего Ху	 Тогд`а же произойдёт утвержд`ение на пост`у председ`ателя ЦВС председ`ателя КНР и генер`ального секретар`я ЦК КПК 61-летнего 
0сов`етской гв`ардии	 63-я годовщ`ина со дня рожд`ения сов`етской гв`ардии отмеч`ается сег`одня 
`этих див`изий	 В сост`ав `этих див`изий вход`или ч`асти рак`етной артилл`ерии кот`орые усп`ешно д`ействовали в бо`ях 
рак`етной артилл`ерии	 В сост`ав `этих див`изий вход`или ч`асти рак`етной артилл`ерии кот`орые усп`ешно д`ействовали в бо`ях 
От`ечественной войн`ы	 В г`оды Вел`икой От`ечественной войн`ы св`ыше 4 5 т`ысяч объедин`ений соедин`ений в`оинских част`ей и корабл`ей Кр`асной `Армии и ВМФ получ`или 
в`оинских част`ей	 В г`оды Вел`икой От`ечественной войн`ы св`ыше 4 5 т`ысяч объедин`ений соедин`ений в`оинских част`ей и корабл`ей Кр`асной `Армии и ВМФ получ`или 
Кр`асной `Армии	 В г`оды Вел`икой От`ечественной войн`ы св`ыше 4 5 т`ысяч объедин`ений соедин`ений в`оинских част`ей и корабл`ей Кр`асной `Армии и ВМФ получ`или 
`этих част`ей	 Для военносл`ужащих `этих част`ей и соедин`ений был учреждён нагр`удный 
беззав`етной пр`еданности	 Гвард`ейцы и сейч`ас сл`ужат образц`ом беззав`етной пр`еданности Р`одине в`оли к поб`еде хр`абрости ст`ойкости 
Моск`овского комит`ета	 ИТАР-ТАСС председ`атель объединённого сов`ета Моск`овского комит`ета ветер`анов войн`ы Бор`ис Гормылев в Москв`е насч`итываются 11 тыс фронтовик`ов гвард`ейцев для кот`орых `это зв`ание ст`ало с`имволом призн`ания м`ужества геро`изма ст`ойкости и 
0м`ассовых коммуник`аций	 Об `этом сег`одня на пресс-конфер`енции в Иркутске заяв`ил мин`истр культ`уры и м`ассовых коммуник`аций РФ 
госуд`арственной подд`ержки	  Т`олько за счёт госуд`арственной подд`ержки м`огут в`ыжить культ`урные прогр`аммы на телев`идении 
музык`ального фестив`аля	 Алекс`андр Сокол`ов наход`ился в Иркутске в связ`и с откр`ытием здесь музык`ального фестив`аля Звёзды на Байкале собравшего так`ие имен`а как Влад`имир Спивак`ов Ел`ена Образцова Г`арри Гродберг Ге`оргий Гаранян 
0футб`ольных ассоци`аций	 Междунар`одная федер`ация футб`ольных ассоци`аций ФИФА в`ыиграла одн`у из с`амых дл`ительных 
миров`ого футб`ола	 Шесть лет пон`адобилось руков`одству миров`ого футб`ола чт`обы полож`ить кон`ец несанкционированному исп`ользованию сво`ей торг`овой м`арки на чемпион`атах м`ира по футб`олу одн`ой из 
торг`овой м`арки	 Шесть лет пон`адобилось руков`одству миров`ого футб`ола чт`обы полож`ить кон`ец несанкционированному исп`ользованию сво`ей торг`овой м`арки на чемпион`атах м`ира по футб`олу одн`ой из 
Междунар`одной федер`ации	 Дир`ектор по маркетингу и ТВ Междунар`одной федер`ации Джером Валке назв`ал `это кр`упной поб`едой ФИФА в борьб`е пр`отив несанкционированного исп`ользования м`арки в глоб`альной компь`ютерной 
несанкционированного исп`ользования	 Дир`ектор по маркетингу и ТВ Междунар`одной федер`ации Джером Валке назв`ал `это кр`упной поб`едой ФИФА в борьб`е пр`отив несанкционированного исп`ользования м`арки в глоб`альной компь`ютерной 
0сейсм`ической акт`ивности	 Ссыл`аясь на анон`имные ист`очники в Сеуле аг`ентство сообщ`ает что южнокорейские сейсм`ологи зарегистр`ировали два очаг`а сейсм`ической акт`ивности на террит`ории КНДР од`ин в`ечером 8 сентябр`я и од`ин р`ано `утром 9 сентябр`я 2004 г Чем б`ыли в`ызваны взр`ывы 
грибов`идной ф`ормы	 Одн`ако несмотр`я на то что вор`онка от взр`ыва оказ`алась наст`олько больш`ой что её удал`ось рассмотр`еть со сп`утника а взрыв был грибов`идной ф`ормы мн`ение америк`анских и южнокорейских эксп`ертов склон`яется к том`у что инцид`ент н`е был 
южнокорейских эксп`ертов	 Одн`ако несмотр`я на то что вор`онка от взр`ыва оказ`алась наст`олько больш`ой что её удал`ось рассмотр`еть со сп`утника а взрыв был грибов`идной ф`ормы мн`ение америк`анских и южнокорейских эксп`ертов склон`яется к том`у что инцид`ент н`е был 
`ядерных испыт`аний	 Госсекретарь США Колин Пауэлл однозн`ачно заяв`ил США счит`ают что КНДР не провод`ила `ядерных испыт`аний по сообщ`ению 
сих пор	 До сих пор не`ясно был ли на с`амом д`еле `этот взрыв `или 
`этой стран`ы	 Северокорейские вл`асти пок`а ник`ак не коммент`ируют сообщ`ения о взр`ыве неподалёку от гран`ицы `этой стран`ы 
кит`айских город`ов	 Южнокорейские СМИ прив`одят мн`ение ж`ителей близлеж`ащих кит`айских город`ов и дерев`ень кот`орые не сл`ышали никак`ого взр`ыва и не в`идели никак`ого 
никак`ого взр`ыва	 Южнокорейские СМИ прив`одят мн`ение ж`ителей близлеж`ащих кит`айских город`ов и дерев`ень кот`орые не сл`ышали никак`ого взр`ыва и не в`идели никак`ого 
кит`айской пров`инции	 Т`акже не поступ`ало пострадавших в рай`онные больн`ицы кит`айской 
больш`ого кол`ичества	 По д`анным ист`очника происш`едшее могл`о быть лесн`ым пож`аром пром`ышленным взр`ывом неуд`ачным з`апуском рак`еты `или детон`ацией больш`ого кол`ичества 
сос`еднего Кит`ая	 Обращ`ается ос`обое вним`ание на то что на террит`ории сос`еднего Кит`ая никт`о не в`идел и не сл`ышал 
`ядерного ор`ужия	 Р`анее многоч`исленные СМИ публиков`али разл`ичные в`ерсии происш`едшего на с`евере КНДР в ночь с 8 на 9 сентябр`я 2004 г Предполаг`алось что в С`еверной Кор`ее могл`и произойт`и испыт`ания `ядерного ор`ужия управл`яемый `или неуправл`яемый взрыв об`ычных вооруж`ений неуд`ачный з`апуск рак`еты ав`ария на пром`ышленном объ`екте и д`аже 
об`ычных вооруж`ений	 Р`анее многоч`исленные СМИ публиков`али разл`ичные в`ерсии происш`едшего на с`евере КНДР в ночь с 8 на 9 сентябр`я 2004 г Предполаг`алось что в С`еверной Кор`ее могл`и произойт`и испыт`ания `ядерного ор`ужия управл`яемый `или неуправл`яемый взрыв об`ычных вооруж`ений неуд`ачный з`апуск рак`еты ав`ария на пром`ышленном объ`екте и д`аже 
анон`имного ист`очника	 Как сообщ`ает информаци`онное аг`ентство Yonhap со сс`ылкой на д`анные анон`имного ист`очника в Пекине `этот взрыв был намн`ого б`олее м`ощным чем взрыв п`оезда в С`еверной Кор`ее в апр`еле с г в результ`ате кот`орого пог`ибли 
с г	 Как сообщ`ает информаци`онное аг`ентство Yonhap со сс`ылкой на д`анные анон`имного ист`очника в Пекине `этот взрыв был намн`ого б`олее м`ощным чем взрыв п`оезда в С`еверной Кор`ее в апр`еле с г в результ`ате кот`орого пог`ибли 
`Южной Кореи	 Тем не м`енее офици`альные вл`асти `Южной Кореи говор`ят что п`овода для 
южнокорейского мин`истра	 По слов`ам южнокорейского мин`истра по дел`ам объедин`ения Чуна Дон Ена никак`их `ядерных испыт`аний С`еверная Корея 
`ядерных испыт`аний	 По слов`ам южнокорейского мин`истра по дел`ам объедин`ения Чуна Дон Ена никак`их `ядерных испыт`аний С`еверная Корея 
`этого м`еста	 Неподалёку от `этого м`еста нах`одится северно-корейская 
`Южной Кореи	 В насто`ящее вр`емя вл`асти `Южной Кореи пыт`аются уточн`ить все 
0кит`айских власт`ей	 Несмотр`я на заявл`ения кит`айских власт`ей о том что рост м`ощи КНР не угрож`ает друг`им стр`анам Кит`ай б`удет стр`оить регион`альную сист`ему безоп`асности и скор`ее всег`о пойдёт по пут`и созд`ания военно-политического `или д`аже 
возм`ожных кандид`атов	 Сред`и возм`ожных кандид`атов на вступл`ение в `этот блок назыв`аются Пакистан 
северокорейского кр`изиса	 Акт`ивное уч`астие КНР в урегул`ировании северокорейского кр`изиса говор`ит о жел`ании Пекина быть полит`ическим игрок`ом 
кр`упных соб`ытия	 В заключ`ении Guardian предск`азывает два кр`упных соб`ытия для Кит`ая к 2020 г Ч`ерез 15 лет Кит`ай скор`ее всег`о сум`еет в`ысадить челов`ека на Лун`у а т`акже вернёт в свой сост`ав 
р`азных соб`ытия	 Два соверш`енно р`азных соб`ытия в один`аковой ст`епени б`удут отраж`ать высоч`айшую ст`епень разв`ития 
сво`их ц`елей	 Ед`инственное что м`ожет помеш`ать Китаю в достиж`ении сво`их ц`елей то `это изв`естная прав`ительственная прогр`амма одн`а семь`я 
молод`ых мужч`ин	 В связ`и с `этой прогр`аммой к том`у же 2020 г в стран`е м`огут появ`иться 40 млн один`оких молод`ых мужч`ин что немин`уемо приведёт к соци`альному взр`ыву посл`едствия 
0изр`аильской `армии	 Соотв`етствующее заявл`ение сд`елал сег`одня нач`альник Геншт`аба изр`аильской `армии Моше Яалон в х`оде сво`ей пресс-конфер`енции передаёт 
сво`ей пресс-конфер`енции	 Соотв`етствующее заявл`ение сд`елал сег`одня нач`альник Геншт`аба изр`аильской `армии Моше Яалон в х`оде сво`ей пресс-конфер`енции передаёт 
никак`их мер	  Сирия не предприним`ает никак`их мер для тог`о чт`обы противод`ействовать проникнов`ению террор`истов в Ирак 
ир`акского реж`има	 Так`им `образом подчеркн`ул генер`ал Дам`аск сотр`удничает со стор`онниками пр`ежнего ир`акского реж`има что знач`ительно 
изр`аильского минюста	 Так глав`а изр`аильского минюста Йозеф Лапид заяв`ил сег`одня что Изр`аиль не нам`ерен начин`ать м`ирные перегов`оры с Сирией до тех пор пок`а офици`альный Дам`аск ок`азывает подд`ержку радик`альным 
тех пор	 Так глав`а изр`аильского минюста Йозеф Лапид заяв`ил сег`одня что Изр`аиль не нам`ерен начин`ать м`ирные перегов`оры с Сирией до тех пор пок`а офици`альный Дам`аск ок`азывает подд`ержку радик`альным 
изр`аильской разв`едки	 Кр`оме тог`о соотв`етствующее заявл`ение сд`елал шеф изр`аильской разв`едки АМАН Аарон Зэви-Фаркаш выступ`ая на эконом`ической конфер`енции заяв`ивший о том что Сирия продолж`ает подд`ерживать д`еятельность террорист`ической 
террорист`ической группир`овки	 Кр`оме тог`о соотв`етствующее заявл`ение сд`елал шеф изр`аильской разв`едки АМАН Аарон Зэви-Фаркаш выступ`ая на эконом`ической конфер`енции заяв`ивший о том что Сирия продолж`ает подд`ерживать д`еятельность террорист`ической 
междунар`одного террор`изма	 Нап`омним Сирия отверг`ает обвин`ения в подд`ержке междунар`одного террор`изма и офици`ально 
иностр`анной оккуп`ации	 При `этом офици`альные вл`асти Сирии не счит`ают террорист`ическими организ`ации вед`ущие вооружённую борьб`у пр`отив иностр`анной оккуп`ации 
полит`ического уб`ежища	 `Эта поз`иция руков`одства стран`ы прояв`илась п`осле соб`ытий 11 сентябр`я 2001 г когд`а Дам`аск осуд`ил `эти террорист`ические `акты одн`ако подтверд`ив при `этом своё нам`ерение продолж`ать предоставл`ение полит`ического уб`ежища представ`ителям радик`альных 
экстрем`истских организ`аций	 Подд`ержка Сирией экстрем`истских организ`аций и группир`овок вед`ущих акт`ивную силов`ую борьб`у пр`отив Изр`аиля явл`яется гл`авным раздражающим ф`актором в двусторонних отнош`ениях и `именно `это даёт п`овод Израилю провод`ить силов`ые `акции 
шестидневной войн`ы	 Т`акже ст`оит отм`етить что друг`ой гл`авной пробл`емой в отнош`ениях м`ежду Израилем и Сирией явл`яются Голанские выс`оты принадлеж`авшие Сирии и оккуп`ированные Израилем в х`оде шестидневной войн`ы в 1967 г а факт`ически аннекс`ированные в 1981 г что н`е было пр`изнано миров`ым со`обществом Сов`ет Безоп`асности О`ОН объяв`ил 
Голанских выс`от	 В 1974 г м`ежду Сирией и Израилем б`ыло подп`исано соглаш`ение об объявл`ении Голанских выс`от б`уферной з`оной и разв`одке войск 
сос`еднего Ливана	 П`осле подпис`ания соглаш`ения Сирия и Изр`аиль выясн`яли сво`и отнош`ения силов`ыми сп`особами на террит`ории сос`еднего Ливана и в ег`о 
90-х гг	 Поп`ытки перегов`оров м`ежду двум`я стр`анами предприним`ались с нач`ала 90-х гг но так ни к чем`у и 
офици`ального заявл`ения	 Сирия в к`ачестве усл`овия нач`ала перегов`оров тр`ебует от Изр`аиля офици`ального заявл`ения об ух`оде с Голанских выс`от офици`альный Изр`аиль с `этим категор`ически не согл`асен тр`ебуя от сир`ийского руков`одства предоставл`ения твёрдых и надёжных гар`антий безоп`асности северо-вост`очных гран`иц 
Голанских выс`от	 Сирия в к`ачестве усл`овия нач`ала перегов`оров тр`ебует от Изр`аиля офици`ального заявл`ения об ух`оде с Голанских выс`от офици`альный Изр`аиль с `этим категор`ически не согл`асен тр`ебуя от сир`ийского руков`одства предоставл`ения твёрдых и надёжных гар`антий безоп`асности северо-вост`очных гран`иц 
сир`ийского руков`одства	 Сирия в к`ачестве усл`овия нач`ала перегов`оров тр`ебует от Изр`аиля офици`ального заявл`ения об ух`оде с Голанских выс`от офици`альный Изр`аиль с `этим категор`ически не согл`асен тр`ебуя от сир`ийского руков`одства предоставл`ения твёрдых и надёжных гар`антий безоп`асности северо-вост`очных гран`иц 
надёжных гар`антий	 Сирия в к`ачестве усл`овия нач`ала перегов`оров тр`ебует от Изр`аиля офици`ального заявл`ения об ух`оде с Голанских выс`от офици`альный Изр`аиль с `этим категор`ически не согл`асен тр`ебуя от сир`ийского руков`одства предоставл`ения твёрдых и надёжных гар`антий безоп`асности северо-вост`очных гран`иц 
северо-вост`очных гран`иц	 Сирия в к`ачестве усл`овия нач`ала перегов`оров тр`ебует от Изр`аиля офици`ального заявл`ения об ух`оде с Голанских выс`от офици`альный Изр`аиль с `этим категор`ически не согл`асен тр`ебуя от сир`ийского руков`одства предоставл`ения твёрдых и надёжных гар`антий безоп`асности северо-вост`очных гран`иц 
междунар`одной м`иссии	 Генер`альный секрет`арь О`ОН Кофи Аннан рекомендов`ал продл`ить манд`ат междунар`одной м`иссии по наблюд`ению за прекращ`ением огн`я на Голанских выс`отах до конц`а декабр`я с г С`илы О`ОН б`ыли размещен`ы на Голанских выс`отах в м`ае 1974 г для наблюд`ения за прекращ`ением огн`я м`ежду изр`аильскими и 
с г	 Генер`альный секрет`арь О`ОН Кофи Аннан рекомендов`ал продл`ить манд`ат междунар`одной м`иссии по наблюд`ению за прекращ`ением огн`я на Голанских выс`отах до конц`а декабр`я с г С`илы О`ОН б`ыли размещен`ы на Голанских выс`отах в м`ае 1974 г для наблюд`ения за прекращ`ением огн`я м`ежду изр`аильскими и 
во`енных наблюд`ателей	 Кр`оме тог`о на Голанских выс`отах нах`одятся 78 во`енных 
0миров`ых комп`аний	 К офшорному аутсорсингу гот`ова треть миров`ых комп`аний Св`ыше 30 комп`аний план`ируют в теч`ение сл`едующих 12 м`есяцев перед`ать ф`ункции подд`ержки сво`ей ИТ-инфраструктуры 
сво`ей ИТ-инфраструктуры	 К офшорному аутсорсингу гот`ова треть миров`ых комп`аний Св`ыше 30 комп`аний план`ируют в теч`ение сл`едующих 12 м`есяцев перед`ать ф`ункции подд`ержки сво`ей ИТ-инфраструктуры 
аутсорсинговой комп`ании	 Так`ое же кол`ичество опр`ошенных рассм`атривают под`обный вари`ант экон`омии расх`одов утвержд`ают в своём н`овом иссл`едовании специал`исты инд`ийской аутсорсинговой 
миров`ых комп`аний	 Аутсорсингом бизнес-проц`ессов т`акже интерес`уется всё б`ольшее кол`ичество миров`ых комп`аний в теч`ение сл`едующего г`ода 34 респондентов план`ируют поруч`ить офшорным специал`истам управл`ение ч`астью 
сл`едующего г`ода	 Аутсорсингом бизнес-проц`ессов т`акже интерес`уется всё б`ольшее кол`ичество миров`ых комп`аний в теч`ение сл`едующего г`ода 34 респондентов план`ируют поруч`ить офшорным специал`истам управл`ение ч`астью 
миров`ых комп`аний	 Опр`ос проведённый сред`и 145 топ-менеджеров вед`ущих миров`ых комп`аний показ`ал т`акже что офшорный аутсорсинг всё б`ольше стан`овится для них 
ч`астных лиц	 `Этому должн`ы спос`обствовать н`изкие нал`оги как для комп`аний так и для ч`астных лиц а т`акже стремл`ение прав`ительств идт`и навстр`ечу н`уждам б`изнеса адапт`ируя законод`ательство для созд`ания ос`обых усл`овий 
ос`обых усл`овий	 `Этому должн`ы спос`обствовать н`изкие нал`оги как для комп`аний так и для ч`астных лиц а т`акже стремл`ение прав`ительств идт`и навстр`ечу н`уждам б`изнеса адапт`ируя законод`ательство для созд`ания ос`обых усл`овий 
технолог`ического ц`ентра	 Исполн`ительный дир`ектор технолог`ического ц`ентра Дубая Dubai Internet City DIC своб`одной з`оны электр`онной торг`овли ОАЭ Бен Сулейман Bin Sulaiman заяв`ил о том что ИТ-подразделения четырёх б`анков двух м`естных одног`о регион`ального и одног`о междунар`одного б`удут превращен`ы в отд`ельные аутсорсинговые комп`ании что позв`олит б`анкам преврат`ить их в ист`очник пр`ибыли а 
своб`одной з`оны	 Исполн`ительный дир`ектор технолог`ического ц`ентра Дубая Dubai Internet City DIC своб`одной з`оны электр`онной торг`овли ОАЭ Бен Сулейман Bin Sulaiman заяв`ил о том что ИТ-подразделения четырёх б`анков двух м`естных одног`о регион`ального и одног`о междунар`одного б`удут превращен`ы в отд`ельные аутсорсинговые комп`ании что позв`олит б`анкам преврат`ить их в ист`очник пр`ибыли а 
электр`онной торг`овли	 Исполн`ительный дир`ектор технолог`ического ц`ентра Дубая Dubai Internet City DIC своб`одной з`оны электр`онной торг`овли ОАЭ Бен Сулейман Bin Sulaiman заяв`ил о том что ИТ-подразделения четырёх б`анков двух м`естных одног`о регион`ального и одног`о междунар`одного б`удут превращен`ы в отд`ельные аутсорсинговые комп`ании что позв`олит б`анкам преврат`ить их в ист`очник пр`ибыли а 
Карибского басс`ейна	 По слов`ам г-на Крейна ег`о `остров уж`е ведёт перегов`оры о заключ`ении мемор`андумов о взаимопоним`ании с Великобританией н`екоторыми госуд`арствами Карибского басс`ейна и 
форс-мажорных обсто`ятельств	 Прав`ительство `острова х`очет получ`ить разреш`ение для регламент`ированных комп`аний осуществл`ять сво`ю д`еятельность с `острова Мэн в сл`учае форс-мажорных обсто`ятельств ураг`анов террорист`ических ат`ак `или 
террорист`ических ат`ак	 Прав`ительство `острова х`очет получ`ить разреш`ение для регламент`ированных комп`аний осуществл`ять сво`ю д`еятельность с `острова Мэн в сл`учае форс-мажорных обсто`ятельств ураг`анов террорист`ических ат`ак `или 
0населённого п`ункта	 Вертолёт выполн`ял пл`ановый полёт Ми 24 уп`ал в рай`оне населённого п`ункта Алхан-Кала прим`ерно в 16 41 по 
нед`авнего круш`ения	 Что же кас`ается нед`авнего круш`ения вертолёта Ми 8 в Ингушетии то по предвар`ительному в`ыводу ком`иссии по рассл`едованию прич`ин ав`арии прич`иной `этому ст`ала 
Вн`утренних войск	 Об `этом не пр`ошлой нед`еле сообщ`ил журнал`истам главк`ом Вн`утренних войск МВД генерал-полк`овник 
населённого п`ункта	 Вертолёт был обнар`ужен 6 сентябр`я в Ингушетии в 1 5 км северо-з`ападнее населённого 
0знамен`итого ф`ильма	 Т`ысячи люд`ей собр`ал`ись на Трафальгарской пл`ощади чт`обы ув`идеть н`овую в`ерсию знамен`итого ф`ильма 
знамен`итого ф`ильма	 Т`ысячи люд`ей собр`ал`ись в воскрес`енье на Трафальгарской пл`ощади чт`обы ув`идеть на больш`ом экр`ане н`овую в`ерсию знамен`итого ф`ильма 
сов`етского кинемат`ографа	 Как передаёт корреспонд`ент РИА Н`овости на больш`ом экр`ане пр`ямо у подн`ожия кол`онны Нельсона все приш`едшие смогл`и ув`идеть знамен`итый шед`евр сов`етского кинемат`ографа но не в прив`ычном нем`ом вари`анте а со специ`ально нап`исанной для 
симфон`ического орк`естра	 В раб`оте над представл`ением уч`астникам гр`уппы помог`али 26 музык`антов Дрезденского симфон`ического орк`естра и изв`естный музык`альный д`еятель 
стр`унных инструм`ентов	 В основн`ом к`адры ф`ильма сопровожд`ались инструмент`альной м`узыкой с`озданной с исп`ользованием электр`онных и стр`унных инструм`ентов в 
полуторачасового ф`ильма	 Музык`альное сопровожд`ение однозн`ачно обогат`ило визу`альный ряд и настро`ение почт`и полуторачасового ф`ильма Серг`ея Эйзенштейна о восст`ании на р`усском корабл`е и ег`о 
Трафальгарской пл`ощади	 Гр`уппа Pet Shop Boys переосм`ыслила худ`ожественные `образы ф`ильма и исп`ользуя символ`изм Трафальгарской пл`ощади напис`ала `этот саундтрек кот`орый даёт ф`ильму н`овую жизнь счит`ают в лондонском Инстит`уте соврем`енного иск`усства кот`орый в`ыступил гл`авным 
соврем`енного иск`усства	 Гр`уппа Pet Shop Boys переосм`ыслила худ`ожественные `образы ф`ильма и исп`ользуя символ`изм Трафальгарской пл`ощади напис`ала `этот саундтрек кот`орый даёт ф`ильму н`овую жизнь счит`ают в лондонском Инстит`уте соврем`енного иск`усства кот`орый в`ыступил гл`авным 
правоохран`ительных `органов	 Необход`имо отм`етить что несмотр`я на н`екоторые опас`ения со сторон`ы правоохран`ительных `органов м`ассовое меропри`ятие прошл`о `очень спок`ойно никак`их серьёзных инцид`ентов зафикс`ировано 
серьёзных инцид`ентов	 Необход`имо отм`етить что несмотр`я на н`екоторые опас`ения со сторон`ы правоохран`ительных `органов м`ассовое меропри`ятие прошл`о `очень спок`ойно никак`их серьёзных инцид`ентов зафикс`ировано 
0кн`ижного д`ела	 Ломоносов кн`ижного д`ела так назыв`ается в`ыставка кот`орая открыв`ается в понед`ельник в Росс`ийской госуд`арственной 
р`усского литер`атора	 В`ыставка посвящен`а 170-летию со дня рожд`ения Алекс`ея Серг`еевича Суворина изв`естного р`усского литер`атора театр`ального д`еятеля просвет`ителя но б`олее всег`о изв`естного как выда`ющегося 
театр`ального д`еятеля	 В`ыставка посвящен`а 170-летию со дня рожд`ения Алекс`ея Серг`еевича Суворина изв`естного р`усского литер`атора театр`ального д`еятеля просвет`ителя но б`олее всег`о изв`естного как выда`ющегося 
р`усской литерат`уры	 Мн`ого б`ыло сд`елано Сувориным для р`усской литерат`уры и для знак`омства с ней 
знач`ительных соб`ытий	 Одн`им из с`амых знач`ительных соб`ытий ст`ало изд`ание к 50-летию со дня см`ерти Алекс`андра Серг`еевича П`ушкина 10-томного собр`ания сочин`ений вел`икого по`эта тираж`ом 100 т`ысяч экземпл`яров в с`ерии изв`естной на всю Росс`ию 
10-томного собр`ания	 Одн`им из с`амых знач`ительных соб`ытий ст`ало изд`ание к 50-летию со дня см`ерти Алекс`андра Серг`еевича П`ушкина 10-томного собр`ания сочин`ений вел`икого по`эта тираж`ом 100 т`ысяч экземпл`яров в с`ерии изв`естной на всю Росс`ию 
вел`икого по`эта	 Одн`им из с`амых знач`ительных соб`ытий ст`ало изд`ание к 50-летию со дня см`ерти Алекс`андра Серг`еевича П`ушкина 10-томного собр`ания сочин`ений вел`икого по`эта тираж`ом 100 т`ысяч экземпл`яров в с`ерии изв`естной на всю Росс`ию 
`этой с`ерии	 Пом`имо `этой с`ерии Суворин основ`ал ещ`е и На`учную дешёвую библиот`еку и 
своег`о от`ечества	 Ос`обое пристр`астие Суворин им`ел к произвед`ениям по ист`ории своег`о от`ечества и на в`ыставке б`удут предст`авлены так`ие альб`омы как Ист`ория Екатер`ины Втор`ой Импер`атор Алекс`андр П`ервый Истор`ическая 
изд`ательской д`еятельности	 Но изв`естно что кр`оме изд`ательской д`еятельности Суворин им`ел ос`обую страсть 
худ`ожественного `общества	 Он был во глав`е литерат`урного худ`ожественного `общества добив`ался от ценз`уры разреш`ения на постан`овки н`екоторых пьес и ст`авил сво`и так`ие наприм`ер как 
н`екоторых пьес	 Он был во глав`е литерат`урного худ`ожественного `общества добив`ался от ценз`уры разреш`ения на постан`овки н`екоторых пьес и ст`авил сво`и так`ие наприм`ер как 
н`овой кн`иги	 В р`амках меропри`ятий к 170-летию со дня рожд`ения Суворина в РГБ кр`углый стол Литерат`урное д`ело в Росс`ии и презент`ация н`овой кн`иги Суворин А С труд`ы 
0дор`ожного движ`ения	 Наруш`итель дор`ожного движ`ения был зад`ержан благодар`я с`обственной сообраз`ительности когд`а обрат`ился к стр`ажам пор`ядка с пр`осьбой показ`ать 
патр`ульной маш`ины	 Но вск`оре мужч`ина обнар`ужил что заблуд`ился и притормоз`ил у патр`ульной маш`ины в кот`орую как раз сад`ились два офиц`ера пол`иции чт`обы 
0был`ых сраж`ений	 На пол`ях был`ых сраж`ений в Новгородской `области в понед`ельник возобнов`ятся 
был`ых сраж`ений	 На пол`ях был`ых сраж`ений в Новгородской `области в понед`ельник возобнов`ятся 
поиск`овой экспед`иции	 Как сообщ`или корреспонд`енту РИА Н`овости в шт`абе Новгородской поиск`овой экспед`иции Дол`ина 13 сентябр`я отр`яды Дол`ины начн`ут раб`оты в рай`оне посёлка Сутоки и в ур`очище Надеевка где в г`оды Вел`икой От`ечественной войн`ы подраздел`ения Кр`асной `Армии вел`и ожесточённые бо`и 
От`ечественной войн`ы	 Как сообщ`или корреспонд`енту РИА Н`овости в шт`абе Новгородской поиск`овой экспед`иции Дол`ина 13 сентябр`я отр`яды Дол`ины начн`ут раб`оты в рай`оне посёлка Сутоки и в ур`очище Надеевка где в г`оды Вел`икой От`ечественной войн`ы подраздел`ения Кр`асной `Армии вел`и ожесточённые бо`и 
Кр`асной `Армии	 Как сообщ`или корреспонд`енту РИА Н`овости в шт`абе Новгородской поиск`овой экспед`иции Дол`ина 13 сентябр`я отр`яды Дол`ины начн`ут раб`оты в рай`оне посёлка Сутоки и в ур`очище Надеевка где в г`оды Вел`икой От`ечественной войн`ы подраздел`ения Кр`асной `Армии вел`и ожесточённые бо`и 
новгородского посёлка	 Предполаг`ается что в раб`отах по п`оиску фронтовик`ов докум`ентов ор`ужия и боеприпасов пр`имут уч`астие отр`яды из город`ов Вел`икий Н`овгород Коломна Моск`овская `область Сольцы и Чудово Новгородская `область а т`акже из новгородского 
населённого п`ункта	 Раб`оты у населённого п`ункта Сутоки и в ур`очище Надеевка бойц`ы Дол`ины пров`одят ежег`одно в теч`ение р`яда 
0